2 13 31
###############################
#p     s* *   #*   *  * * *   #
# # # #*# # #***# # # #*#*#*# #
#           * #*      *   * * #
# # # # # #*# * #*#*# # # # #*#
#f        *5 *#  *  *         #
# # # # # # # # # #*# #*# # # #
#*         *  *      *        #
# # # # #*# # # #*#*# # # # # #
#*    *   *x  #   *           #
# #*# # # # # # #*# # # # # # #
#  #4*     * ** 3*  *         #
###############################


