3 13 31
###############################
#p     ** *  1 * 2 *  * * *   #
# # # #*# # #*#*# # # #*#*#*# #
#   *  1  ***  *  1   * 2 * * #
# # # # # #*# # #*#*# # # # #*#
#    1  1    **  *  *   1     #
#b# # # # # # # # #*# #*# # # #
#*  *  1   *  *  3   *        #
# # # # #*# # # #*#*# # # # # #
#*    **  *       *       x   #
# #*# # # # # # #*# # # # # # #
#     3   3 *   *  *          #
###############################