2 13 31
###############################
#p     ** *   #*   *  * * *   #
# # # #*# # #*#*# # # #*#*#*# #
#   *  1  *** #*      *   * * #
# # # # # #*# # #*#*# # # # #*#
#f         2 *#  *  *         #
# # # #x# # # # # #*# #*# # # #
#*  *  1   *  #      *        #
# # # # #*# # # #*#*# # # # # #
#*    **  *   #   *           #
# #*# # # # # # #*# # # # # # #
#           * # *  *          #
###############################


