3 13 31
###############################
#p     ** *  1 * 2 *  * * *   #
# # # #*# # #*#*# # # #*#*#*# #
#   *  1  ***  *  1   * 2 * * #
# # # # # #*# # #*#*# # # # #*#
#f   1  1  x **  *  *   1     #
# # # # # # # # # #*# #*# # # #
#*  *  1   *  *  3   *        #
# # # # #*# # # #*#*# # # # # #
#*    **  *       *           #
# #*# # # # # # #*# # # # # # #
#     3   3 *   *  *          #
###############################