2 13 31
###############################
#p     ** *   #*   *  * * *   #
# # # #*# # #*#*# # # #*#*#*# #
#   *  1  *** #*      *   * * #
# # # # # #*# # #*#*# # # # #*#
#f         2 *#  *  *    3    #
# # # #x# # # # # #*# #*# # # #
#*  *  1   *  #      *        #
# # # # #*# # # #*#*# # # # # #
#*    **  * 3 #   *           #
# #*# # # # # # #*# # # # # # #
#           * # *  *          #
###############################


